R 3300 2600


S ressources/barrel.xpm
WE      ressources/tex_mur_brique.xpm
SO ressources/texture_mur_fleurs-_1_.xpm
         NO ressources/texture_mur_pierre.xpm


EA ressources/texture_mur_pierre_grises.xpm
F 0,191,255
C 225,179,255


     1111111111111111111
11111111100000020000001111111111111111111
1200000000110000000000000201111
1011001111111102020200100010001111
1001001     1000000000S200001000111111
1011001     111000002101000100000000111
1000001     1000000111211110001111000111
1111001    11111111101110002011111111001
1100001   110100111101010000000110000021
110000111110101110000001110000000000111111
1000200000000000000000000000111111111
100000000000000011010100100011
11000000110101011111011110201
11200000111111011111011110001
11111111111111111111111111111